NO ./texture/wallNorth.xpm
WE ./texture/wallWest.xpm
SO ./texture/wallSouth.xpm
EA ./texture/wallEast.xpm

F 220,100,0
C 225,30,0






        1111111111111111111111111
        1000000000110000000010001
        10110000011100000001N1001
        1001000000000000000010001
111111111011000001110000000000001
100000000011000001110111111111111
11110111111100011100000010001
11111111111100011111111111111
11111111111111111111111111111
11111111111100011111111111111
11111111111100011111111111111
11110111111100011101010010001
1111111111111111111111111111
1111111111111111111111111111
1100000011010101110000010001
10000000000000001100000010001
10000000000000001101010010001
1000000111010101111101111000111
10110111 1110101 101111010001
 1111111 1111111 1111111 111
