NO ./texture/wallNorth.xpm
SO ./texture/wallSouth.xpm
WE ./texture/wallWest.xpm
EA ./texture/wallEast.xpm

C 69,80,59
F 176,152,164

1111111111111111111111111
1000000000110000000111001
101100000111000N0001 1001
1001011111111110000111001
111101        10011100001
1000011111111110011111111
1110011111111100110000001
1110011111111101110101001
1100000011010101110000001
1000000000000000110000001
1000000000000000110101001
1100000111010101111101111
1111011101110101010111101
1111111111111111111111111